{
  "schema_version": "1",
  "andes_version": "2.0.x",
  "source_case": "ieee39.raw",
  "last_modified": "2026-05-07T00:00:00.000Z",
  "coordinates": {
    "1": { "x": 200, "y": 200 },
    "2": { "x": 350, "y": 150 },
    "3": { "x": 500, "y": 150 },
    "4": { "x": 600, "y": 250 },
    "5": { "x": 700, "y": 300 },
    "6": { "x": 800, "y": 250 },
    "7": { "x": 850, "y": 350 },
    "8": { "x": 800, "y": 450 },
    "9": { "x": 200, "y": 350 },
    "10": { "x": 700, "y": 450 },
    "11": { "x": 750, "y": 550 },
    "12": { "x": 650, "y": 600 },
    "13": { "x": 600, "y": 500 },
    "14": { "x": 500, "y": 450 },
    "15": { "x": 450, "y": 550 },
    "16": { "x": 500, "y": 650 },
    "17": { "x": 400, "y": 350 },
    "18": { "x": 350, "y": 250 },
    "19": { "x": 600, "y": 750 },
    "20": { "x": 500, "y": 800 },
    "21": { "x": 600, "y": 650 },
    "22": { "x": 700, "y": 700 },
    "23": { "x": 750, "y": 750 },
    "24": { "x": 600, "y": 350 },
    "25": { "x": 250, "y": 100 },
    "26": { "x": 350, "y": 450 },
    "27": { "x": 400, "y": 450 },
    "28": { "x": 250, "y": 500 },
    "29": { "x": 200, "y": 600 },
    "30": { "x": 100, "y": 100 },
    "31": { "x": 900, "y": 100 },
    "32": { "x": 950, "y": 300 },
    "33": { "x": 900, "y": 550 },
    "34": { "x": 850, "y": 700 },
    "35": { "x": 700, "y": 800 },
    "36": { "x": 500, "y": 900 },
    "37": { "x": 100, "y": 700 },
    "38": { "x": 100, "y": 500 },
    "39": { "x": 100, "y": 300 }
  }
}
